XXXXXXXXXXX
X X X     X
E X X X XXX
X X   X   X
X XX   XX X
X    S  X X
XXXX    X X
X     X   X
X X XXXXX X
X X       E
XXXXXXXXXXX
