XXXXXXXEXXXXXXXXXXXXXXXXXXXXXXXXXXXXXXXXXXXXXXXXXXX
X X         X       X   X         X         X   X X
X XXXXXXX X XXX X XXX X X XXXXX X X XXX XXX X X X X
X         X   X X     X X   X   X X X X X     X   X
XXXXXXXXXXXXX X XXXXXXX XXX X XXXXX X X XXX XXXXXXX
X   X     X X X   X   X     X X   X   X   X X     X
X X X XXX X X XXXXX X XXX XXX X X XXX XXX XXX XXX X
X X X X X X X       X   X X   X X   X X X X   X X X
X X X X X X XXXXXXXXXXX XXX XXX X XXX X X X XXX X X
X X   X     X   X     X   X X   X     X X       X X
X XXXXXXX XXX X X X X XXX X X XXXXXXXXX XXXXXXXXX X
X       X X   X   X X   X X X X         X         E
X XXXXX XXX XXXXXXX XXXXX X X XXXXXXX X X XXXXXXX X
X X   X X   X   X X   X   X   X     X X X   X     X
X X X X X XXX X X XXX X XXXXX X XXX X X XXX X XXXXX
X   X X X     X     X       X   X X   X X X X     X
XXXXX X XXXXXXXXXXX XXXX S  XXXXX XXXXX X X XXXXX X
X   X X         X X           X           X   X X X
X XXX XXXXX XXX X XXXXXXXXXXX XXX XXXXXXX XXX X X X
X X   X   X   X   X         X   X X     X X   X X X
X X XXX X XXX XXX XXXXX XXX XXX XXX XXX X X XXX X X
X X X   X   X   X       X X X   X   X   X X X   X X
X X XXX XXX XXX XXXXXXXXX X X XXX XXX XXX X X X X X
X   X   X X   X X X         X X   X   X   X X X X X
X XXX XXX XXX X X X XXXXXXXXX X XXX XXXXXXX XXX X X
X     X   X   X X   X   X   X X X     X     X   X X
XXXXXXX XXX XXX X XXX X X X X X XXXXX X XXXXX XXX X
X X     X   X   X X   X   X X X   X X   X     X   X
X X XXX X XXX XXXXX XXXXXXX X X X X XXXXX XXXXX XXX
X X X X   X   X   X X     X   X X X   X     X   X X
X X X XXXXX XXX X X XXXXX XXXXXXX X XXX XXX X XXX X
X         X     X                 X       X       X
XXEXXXXXXXXXXXXXXXXXXXXXXXXXXXXXXXXEXXXXXXXXXXEXXXX
