XXXXXXEXXXX
XXXXXX XXXX
XXXXXX XXXX
XXXXXXXXXXX
XXXX   XXXX
XXXX S    E
XXXX   XXXX
XXXX XXXXXX
XXXX XXXXXX
XXXX XXXXXX
XXXXEXXXXXX