XXXXXXXXXXXXXXXXXXXXXXX
X       P   X     X   X
  XXXXXXXXX XXX X X X X
X X     X   X   XP  X  
X X XXX X XXX XXXXXXX X
X   X   X     X     X X
X XXX XXX  S XX XXXXX X
X   X X       X X   X X
XXXXX X XXX X X X X X X
X     X X   X X   X X X
X XXXXX XXXXX X XXX X X
X             X   X   X
XXXXXXXXXXXXXXXXXXXXXXX
