XXXXXXXXXXXXXEXXXXXXXXXXXXXXXXXXXXXXXXXXXXXXXXXXXEXXXXXXXXXXXXXXXXXXXXXXXXXXXXXXXXXXXXXXXXEXXXXXXXXXXXXXXEXXXXXXXEXXXXXXXXXXXXXXXXXXXXXXXXXXXXXXXXXXXXX
X     X     X     X                   X         X       X                   X         X               X   X     X         X             X         X   X
XXXXX X X X X XXX X X XXXXX XXXXXXXXX X X XXXXXXX XXX X X XXXXXXXXXXX XXXXX X XXXXX X XXX XXX XXXXXXX X XXX X X X XXXXX X XXXXX X XXXXX X XXXXXXX X X X
X     X X X X X X   X     X X   X X   X X X       X   X X     X       X   X X X     X     X   X   X   X     X X X     X X     X X X   X   X   X X X X X
X XXXXX X XXX X XXXXXXXXX X X X X X XXX XXX XXXXXXX XXXXXXX XXX XXXXX X X XXX X XXXXXXXXX XXXXX X X XXX XXXXX XXXXX XXX XXXXX X X XXX XXXXX X X X XXX X
X X X   X     X       X   X X X X   X       X   X X X       X   X   X X X     X     X   X X     X X X       X       X   X   X X X   X       X   X X   X
X X X XXXXXXXXXXXXX X X XXX X X X XXXXXXXXX X X X X X XXXXXXX XXX X XXX XXXXXXXXXXX X X XXX XXXXX X XXXXXXXXXXXXX XXX XXXXX X XXXXX XXXXXXX XXXXX X XXX
X X   X             X X X   X X X         X   X   X   X     X     X   X X         X   X   X     X X   X         X   X     X       X X       X   X X   X
X X XXX XXXXXXXXX XXXXX X XXX X XXXXXXXXX XXXXXXXXX XXXXX X XXXXXXXXX X XXXXX XXXXXXX XXX XXXXX X XXX X XXXXXXX XXXXX XXX XXXXXXX X X XXXXX X X X XXX X
X X   X X     X   X     X X   X     X   X         X X     X     X     X       X     X X     X X X X     X     X     X   X   X   X   X   X   X X   X   X
X XXX X X XXX X XXX XXXXX X XXXXXXX X X XXXXXXXXX X XXX XXXXXXX X XXXXXXXXXXX X XXX XXX XXX X X X XXXXXXX X X XXXXX XXX XXX X XXXXXXXXX X XXX XXXXX X X
X X     X   X X X X X     X   X   X   X X       X X   X X X   X X   X       X X   X     X     X X     X X X X     X X     X X     X     X X   X     X X
X XXXXXXXXX X X X X XXX XXXXX X XXXXXXX X XXXXX X XXX X X X X X XXX X XXXXX X XXX XXXXXXX XXXXX XXXXX X X X XXX XXX X XXXXX XXXXX X X XXX X XXXXX XXX X
X     X     X X X X   X X   X   X   X   X X     X X X   X   X X X X X     X   X X     X     X     X   X   X   X X   X X   X     X   X   X X     X   X X
XXXXX XXXXX X X X XXX XXX X X XXX X X XXX XXXXXXX X XXXXXXXXX X X X XXXXX XXXXX XXXXX XXXXXXX XXXXX XXX XXXXX X X XXXXX X X XXX X XXXXX XXXXXXX X X X X
X   X     X X X   X   X   X X X   X X X X   X     X           X   X       X       X   X       X     X X     X X X   X   X X X   X X   X       X X X X X
E XXXXXXX X X X XXX XXX XXX X X XXX X X X X X XXXXX X XXX XXXXXXX XXXXXXXXX XXX XXX X X XXXXXXX XXXXX XXX XXX X XXX X XXX X X XXX X XXXXXXXXX X XXX X X
X         X X   X   X   X X   X   X   X   X X     X X X   X     X X   X X   X X   X X X   X   X   X       X   X   X   X   X X X   X     X     X   X X X
X XXXXXXXXX XXXXX X X XXX XXXXXXX XXXXX XXX XXXXX X X XXX X X XXX X X X X XXX XXX X X XXX XXX XXX X XXXXXXX XXXXX XXXXX XXXXX X XXXXX XXX XXX XXX X X X
E   X     X X   X X X     X     X X   X X X     X X X   X X X     X X X   X     X X X   X   X X   X X     X X     X   X X   X X       X   X   X X   X X
XXX X XXX X X X X XXXXXXX X XXX X X X X X X XXXXX XXXXX X X XXXXXXX X X XXX XXX X X XXX XXX X X XXX XXX XXX XXXXX X X X X X X XXXXXXX X XXX XXX XXXXX X
X   X X X X   X X       X X X   X   X X   X X   X X     X X         X X X     X X X   X X   X X X X X   X   X   X   X X   X   X       X X X       X X X
X XXX X X XXXXX XXXXX X X XXX X XXXXX XXXXX X X X X XXXXXXXXXXXXXXXXX X XXXXXXX X XXX XXX XXX X X X X XXX X X X XXXXXXXXXXXXXXX XXXXX X X XXXXXXX X X X
X   X X X X     X   X X       X     X     X   X   X           X       X       X X   X   X     X X X X   X X X X X     X         X   X X X       X   X E
XXX X X X X XXXXX X XXXXXXXXXXXXXXX XXXXX X XXXXXXX XXXXXXX X X XXXXXXXXXXXXX X X XXXXX XXXXX X X X X X X X X X X XXX X XXXXXXXXX X XXX X X XXXXX XXX X
X   X X X   X   X X     X         X X   X X     X       X   X X       X         X     X       X X X X X X X X X X   X X X         X   X X X       X   X
X XXX X XXXXXXX X XXXXX XXXXXXXXX X X X X XXXXX XXXXXXX X XXXXXXXXXXX XXXXXXXXX XXX XXXXXXXXXXX X X XXX X XXX X XXX X X X XXXXXXXXXXX X X XXXXXXXXX XXX
X X             X X   X     X     X   X X X   X X     X X       X   X       X X X X     X X   X X   X   X     X   X X   X       X   X   X X     X X X X
X XXXXXXXXXXXXX X XXX XXXXX X XXXXX XXXXX XXX X X XXX XXXXXXX XXX X XXXXXXX X X X XXX X X X X X X XXX X XXXXXXXXX X XXXXXXXXXXX X X XXXXX XXX X X X X X
X   X         X X X     X   X   X   X   X X   X X X X   X     X   X   X   X X X X   X X   X X   X     X     X X   X   X   X   X   X     X     X   X   X
XXX X XXXXXXX XXX X XXXXX XXX X X XXX X X X X X X X XXX X XXXXX XXXXX X X X X X X X X XXXXX XXXXX XXXXXXXXX X X XXXXX X X X X XXXXXXXXX XXXXXXXXXXXXX X
X X X   X   X X   X     X X   X X X X X   X X X X X   X   X     X X   X X   X   X X X     X     X X       X X X X   X X X X X X   X     X   X         X
X X XXX X X X X XXX XXX X XXX X X X X XXXXX XXX X XXX XXX X XXXXX X XXX XXXXXXX X X XXXXX XXXXX XXX XXXXX X X X X X X X X X X X X X XXX X X X XXXXXXXXX
X X     X X X   X     X X   X X     X     X X   X   X     X X     X   X       X   X   X     X X     X     X X X X X   X X X X   X   X   X X   X   X   X
X XXXXXXX X XXXXXXXXXXX XXX X XXXXXXXXXXX X X XXXXX XXXXXXX XXX X XXX X XXXXX XXXXX XXX XXX X XXXXXXX XXXXX X X X XXXXX X X XXXXXXXXXXXXX XXXXX X X XXX
X   X     X           X X   X X X         X X X   X       X   X X   X   X   X   X   X   X   X       X X       X X       X X               X     X X   E
X X X XXXXX X XXXXXXX X X XXX X X XXXXXXXXX X X X XXXXXXX XXX X XXX XXXXX X XXX XXXXX XXX XXXXX XXX X XXXXXXXXX XXXXXXXXX XXXXXXXXXXXXXXXXX XXXXX XXX X
X X X X   X X X     X   X X     X X X       X   X     X     X   X X   X   X X         X X X     X   X       X     X       X       X             X     X
XXX X X X X XXX XXX XXX X X XXXXX X X XXX X XXXXXXXXX X XXX XXXXX X XXX XXX XXXXXXXXXXX X X XXX XXXXXXXXX X X XXX X XXXXXXX XXXXX XXXXXXXXXXX X XXXXXXX
X   X   X X X   X X   X X X X     X X X X X   X     X X X     X     X   X X           X X   X   X       X X X   X X     X   X X   X         X X       X
X XXXXXXX X X XXX XXX XXX XXX XXXXX X X X XXX X XXX X X XXXXXXX XXXXX XXX XXXXXXXXXXX X XXXXX XXX XXXXX X X XXX XXXXXXX XXX X X XXX XXXXXXX XXXXXXXXX X
X       X X   X     X   X X   X     X   X X X X X   X X           X X X       X     X X     X   X   X   X X   X       X     X X X   X     X X     X   X
X XXXXX X XXXXX X XXXXX X X XXX XXXXXXX X X X X X XXX XXXXXXXXXXX X X XXX XXX X X XXX X XXX XXX XXX X XXXXX X XXX XXXXXXXXXXX X XXX XXX X X X XXX X XXX
E   X   X     X X     X X X X   X   X   X X     X X   X         X   X   X   X X X     X X   X   X   X     X X   X             X X   X   X X   X   X   X
XXX X XXXXXXX X XXXXX X X X XXX X X X XXX X XXXXXXX XXX XXXXXXX XXXXXXX XXXXX X XXXXXXXXX X X XXX XXXXXXX XXXXX X XXXXXXXXX X X X XXX XXX XXXXX XXXXX X
X   X   X     X   X   X   X   X X X X X   X X   X   X   X     X       X X   X X   X     X X X X   X   X         X     X     X X X X   X X X   X   X   X
X XXXXX X XXXXXXXXX XXXXXXX X X X X X X XXX X X X XXXXX X XXX XXXXXXX X X X X XXX XXX X X XXX X XXX X XXXXXXXXXXXXXXX X XXXXXXX X X X X X X X XXX X X X
X     X X X       X     X   X X X X   X   X X X   X     X X X X     X   X X X   X     X X   X X   X X   X             X X     X   X X X   X X   X   X X
XXXXXXX X XXX XXX XXX X X XXX X X XXXXXXX XXX XXXXX XXXXX X X X XXX XXXXX X X X XXXXXXX XXX X XXX X XXX XXXXXXXXXXX XXX X XXX XXXXX X XXXXX XXX XXXXX X
X     X X     X X   X X   X   X X   X X   X   X     X     X   X   X           X     X   X   X X   X   X           X   X   X X     X X       X X       X
X XXX X XXXXXXX XXX XXX XXX XXX XXX X X X X XXX XXXXX XXXXX XXXXXXXXX XXXX S  X XXXXX XXX XXX X XXXXX XXXXXXXXXXX XXX XXXXX XXX XXX XXXXXXXXX XXXXXXXXX
X   X       X     X   X X   X   X X X X X X     X     X   X     X     X       X X     X       X     X       X   X X   X       X   X       X           X
X X X XXXXXXX XXX XXX XXX XXX X X X X X XXXXXXXXX XXXXX X XXXXX X X XXXXX XXXXXXX XXXXX XXXXXXXXXXX XXXXXXX XXX X X XXXXX XXX XXX XXXXXXX XXX X XXXXX X
X X X X       X X   X     X   X   X   X X   X     X   X X X   X   X X   X   X     X X   X         X       X     X X   X   X X X X   X   X   X X   X   X
XXX X X XXXXXXX XXX XXXXXXX XXX XXXXX X X X X XXX X X X X XXX XXXXX X X XXXXX XXXXX X XXX XXXXXXX XXX XXX XXXXX X XXX X XXX X X X XXX X XXX XXXXX XXXXX
X   X X X         X   X     X   X     X X X   X X   X   X X   X     X X X     X     X X X X   X   X   X   X X   X X X X X     X X   X X   X X     X   X
X XXX X XXXXX XXX XXX X XXX X XXX XXXXX X XXXXX XXXXXXXXX X XXX XXXXX X X XXXXX X XXX X X X X X XXX XXX XXX X XXX X X X X XXXXX XXX X X XXX X XXXXX X X
X   X X       X     X X   X X X   X   X X X       X       X X   X   X X   X X   X X   X     X X   X X   X   X   X X     X         X   X   X X   X   X X
XXX X XXX XXXXXXXXXXX X XXX XXX XXX X X X X XXXXX X XXXXXXX X XXX X X XXXXX X XXX X XXXXXXX XXXXX X XXX X X X XXX XXXXXXXXXXXXX XXXXXXXXX X X X X XXX X
X   X X   X         X   X   X   X   X X X X   X   X X   X     X   X X X   X   X   X     X   X     X   X   X X X   X   X       X X     X   X X X     X X
X XXX X XXX XXXXXXX XXXXX X X XXX XXX X X X X XXX X X XXX XXXXX XXX X X XXX XXX X XXXXX XXXXX XXXXXXX X XXXXX X XXX X XXX XXXXX X XXX X X X XXXXXXXXX X
X   X X   X X X   X X     X X X X   X X X X X   X X X         X X X   X X   X   X X   X     X       X X X     X     X X   X   X X X   X X X   X     X X
X X XXXXX X X X X X X XXX XXX X XXX X X X X XXX X X XXXXXXXXXXX X XXXXX X XXX XXX X X XXXXX X XXX XXX XXX XXXXXXXXXXX X XXX X X X X XXX XXXXX X XXX X X
X X   X   X X X X   X X   X   X     X X   X   X X X   X       X X X     X   X X   X X X X   X X   X   X   X X       X X   X X X X X X   X       X     X
X XXX X XXX X X XXXXX X XXX XXX XXXXX XXXXXXXXX XXXXX X XXXXX X X X X XXX XXX X XXX X X X XXX X XXX XXX XXX X X XXX X X X X X X X X X X X XXXXXXXXXXXXX
X   X   X   X X       X   X X       X         X     X   X   X   X   X X   X   X     X   X   X X   X     X X   X X   X X X   X   X X X X     X         X
XXX XXXXX XXX XXXXXXXXXXX X XXXXXXX X XXXXXXX XXX XXXXXXXXX XXXXXXXXX X XXX XXXXXXX XXXXXXX XXXXX XXXXXXX X XXX XXX X XXXXX XXXXX X XXXXXXX X XXXXXXX X
X   X   X   X       X   X X X   X   X X     X   X         X X         X   X X       X     X     X       X     X   X X     X X   X X       X X X   X   X
X XXX X XXX XXXXXXX X X X X X X XXXXX X XXX XXX X XXX XXX X X XXX X XXXXX X XXXXXXXXX XXX XXXXX XXX XXX XXXXXXXXX X XXXXX XXX X X XXXXXXX XXX X XXX XXX
X X   X   X       X   X   X   X X     X X X X   X X   X X   X X X X X     X           X       X     X X         X X X   X X   X X X     X     X   X   X
X XXX XXXXXXXXXXX XXX XXXXXXXXX X XXXXX X X X XXX X XXX XXX X X X XXX XXXXXXXXXXXXXXXXX XXXXX XXXXXXX XXXXXXXXX X X XXX X X XXX X XXXXX XXXXXXXXX XXX X
X   X         X X   X X     X   X         X X   X X   X     X X X   X     X         X X X   X X       X       X X X X   X X X X X           X       X X
XXX X XXXXX X X XXX XXX X X X XXXXXXXXXXX X XXX XXXXX X XXXXX X XXX XXXXX XXXXX XXX X X XXX X XXX X XXX XXXXX X X X X XXX X X X XXXXXXXXXXX XXX XXXXX X
X   X     X X     X     X X X           X X X         X   X   X   X   X X X     X     X   X     X X       X   X   X X   X   X X           X     X     X
X XXXXXXX X XXXXXXXXXXXXX X XXXXXXXXXXX X X XXXXXXXXXXXXXXX XXXXX X X X X X XXXXX XXXXXXX XXXXX XXXXX XXXXX X XXXXX XXX XXXXX XXXXXXXXXXX XXXXX X XXX X
X   X   X X X         X   X X         X X X           X     X     X X   X X X     X   X   X   X     X X     X X   X   X       X   X     X     X X   X X
XXX X XXX X X XXX XXX X XXX X XXXXXXX X X XXXXXXXXXXX X XXXXX XXXXX XXXXX X X XXXXX X X XXX X XXXXX X X XXXXX X XXXXX X X XXX X X XXXXX X XXXXX XXX XXX
X   X     X   X X X   X   X   X     X X X X X     X   X   X   X     X   X   X     X X   X   X   X X X X   X X X     X X X X   X X   X   X     X   X   X
X XXXXX XXXXXXX X X XXXXX XXXXX XXXXX X X X X XXX X XXXXX XXX X XXX X X XXXXXXXXX X X XXX XXXXX X X XXXXX X X X XXX X XXX XXX X XXX X XXXXXXX XXX XXX X
X     X X X     X X   X   X X         X X   X X X X     X     X X   X X   X   X   X X X       X X         X X X X   X   X   X   X   X     X   X     X X
XXXXX X X X XXX X XXXXX XXX X XXXXXXX X XXX X X X X XXX XXXXX X XXXXX X X X X X XXX X X XXXXXXX XXXXXXXXXXX X XXX X XXX X X XXXXX XXXXX X X XXX XXXXX X
X   X X X     X X X   X X   X   X   X X   X X X   X X X       X X     X X X X X   X X X X X     X   X             X X X X X X   X       X X   X X     X
X X X X XXXXX X X X X X X X XXX X X X XXX XXX XXX X X XXXXXXXXX X XXXXX XXX X XXX X XXX X X XXXXX X XXX XXXXXXXXXXX X X XXX X X XXXXXXXXX XXX X X XXXXX
X X X X     X X X   X X X X     X X X   X   X   X X X         X X X   X     X     X X   X X       X   X   X       X   X X   X X   X       X X   X     X
X X X XXXXX XXX XXXXX X XXX XXXXX X XXXXXXX XXX X X XXXXX X XXX X X X XXXXXXXXXXXXX X XXX XXXXXXXXXXX XXX X XXXXX XXX X X XXX XXX X XXXXXXX XXXXXXXXX X
E X   X   X       X   X   X   X   X       X     X X       X X   X   X X       X     X   X     X     X   X X   X X X   X   X X X X X         X     X   X
X XXXXX X XXXXXXX X XXXXX XXXXX XXXXXXXXX XXXXXXX XXXXXXXXXXX XXXXXXX X XXXXX X XXX XXX X XXX X XXX X X XXXXX X X XXXXXXXXX X X X XXXXXXXXX XXX XXX X X
X X     X     X   X     X     X X X     X     X X     X     X       X X   X X X X   X   X   X X X   X X     X X X     X         X             X X   X X
X X XXXXX XXX X XXXXX XXXXXXX X X X X XXX XXX X XXXXX X XXX X XXXXX X XXX X X X XXXXX XXXXX X X X XXXXXXX X X X XXXXX X XXXXXXX XXXXXXXXXXXXX X X XXXXX
X X X   X X   X X     X     X   X   X   X   X     X X X   X X     X X     X   X   X   X     X X X       X X X     X X   X   X X X       X   X   X     X
X X XXX X X XXX X XXXXX X XXXXXXX XXXXX XXX XXXXX X X XXX X XXXXXXX XXX XXXXXXXXX X XXXXXXXXX X XXXXXXX X X XXXXX X XXXXX X X X XXX X XXX X XXX XXXXX X
X X     X X X   X       X X       X   X   X X   X   X X   X       X     X       X   X         X   X     X X           X X X X       X X   X   X X     X
X XXXXX X XXX XXXXXXXXXXX X XXXXXXX X X X X X X XXX X X XXXXXXXXX XXXXXXX XXXXX X XXXXX XXXXXXXXX X XXXXXXXXXXXXXXXXX X X X X XXXXXXXXX XXXXX XXX XXX X
X     X X X   X     X X   X   X   X X   X X X X   X X X   X       X       X   X X       X         X X               X   X X X X   X     X   X     X   X
XXXXX XXX X XXXXX X X X XXXXX X X X XXXXX X X XXX X X X X X XXXXXXX XXXXXXX XXX XXXXXXXXX XXXXXXXXX XXX XXXXXXXXXXX XXXXX X XXX X X XXXXX X XXXXXXX XXX
X   X   X         X   X         X X X   X X   X   X X X X X         X X   X   X           X       X X   X         X       X     X X X     X X     X   X
X X XXX XXXXXXX XXXXX XXXXXXXXXXXXX X X XXXXXXX XXX X XXX XXXXXXXXXXX X X X X XXXXXXXXXXXXX XXXXX X X XXX X XXXXXXXXXXXXXXXXXXXXX X X XXXXX X XXX XXX X
X X   X       X X   X   X       X   X X         X   X   X   X X       X X X X       X     X   X X X X   X X X   X   X   X     X   X X X X   X X X   X X
X X XXXXXXXXX XXX X XXXXX XXXXX X X X XXXXXXXXXXXXXXXXX XXX X X XXXXX X X X XXX XXXXX XXX XXX X X X XXX X XXX X X X X X X XXX X XXX X X X XXX X XXX X X
X X               X       X       X X                       X       X   X     X         X       X       X     X       X     X       X   X         X   X
XXXXXXXXXXXXXXXXXXXXXXXXXXXXXXXEXXXXXXXXXXXXXXEXXXXXXXXXXXXXXXXXXXXXXXXXXXXXXXXXXXXXXXXXXXXXXXXXXXXXXXXXXXXXXXXXXXEXEXXXXXXXXXXXXXXXXXXXXXXXXXXXXXXXXXX
