XXXXXXEXXXX
XXXXXX XXXX
XXXXXX XXXX
XXXXXXXXXXX
XXXX   XXXX
XXXX S X  E
XXXX   XXXX
XXXXXXXXXXX
XXXX XXXXXX
XXXX XXXXXX
XXXXEXXXXXX